Vertex Count: 6

Data:

-8 0 -8 0 1 0 1 -0
-8 0 8 0 -7 0 1 -0
8 0 -8 8 1 0 1 -0
-8 0 8 0 -7 0 1 -0
8 0 8 8 -7 0 1 -0
8 0 -8 8 1 0 1 -0
